{
	"width": 15,
	"height": 15,
	"baseLayer": {
		"ids": [
			"GROUND_2_0",
			"GROUND_1_0",
			"WATER"
		],
		"grid": [
			"111111110000000",
			"122222211111111",
			"122222211111111",
			"122222211111111",
			"122222211111111",
			"122222211111111",
			"122222211111111",
			"111111110100100",
			"000000011133111",
			"000000011133111",
			"000000011133111",
			"000000011133111",
			"000000011133111",
			"000000011133111",
			"000000011111111"
		]
	},
	"overLayer": {
		"ids": [
			"1_0_0_1",
			"2_0_0_1",
			"2_0_2_1"
		],
		"grid": [
			"000000000000000",
			"000000000000000",
			"000000010000000",
			"000000000000000",
			"000000000000000",
			"000000000000000",
			"000000000000000",
			"000000000000000",
			"000000000023000",
			"000000000023000",
			"000000000023000",
			"000000000023000",
			"000000000023000",
			"000000000023000",
			"000000000000000"
		]
	},
	"wallLayer": {
		"ids": [
			"2_0",
			"0_0"
		],
		"grid": [
			"111111122222222",
			"100000020000002",
			"100000000000002",
			"100000020000002",
			"100000020000002",
			"100000020000002",
			"100000020000002",
			"111111122022022",
			"000000020000002",
			"000000020000002",
			"000000020000002",
			"000000020000002",
			"000000020000002",
			"000000020000002",
			"000000022222222"
		]
	},
	"attribLayer": {
		"ids": [
			"BLOCK",
			"ITEM: coins",
			"OBJECT: ore_copper",
			"OBJECT: torch_common",
			"OBJECT: ore_depleted"
		],
		"grid": [
			"111111111111111",
			"100000210000001",
			"103000000000401",
			"100000010000001",
			"100000010000001",
			"100030010000001",
			"100000010050001",
			"111111111011011",
			"000000010011001",
			"000000010011001",
			"000000010011001",
			"000000010011001",
			"000000010011001",
			"000000010011501",
			"000000011111111"
		]
	}
}