{
	"width": 10,
	"height": 11,
	"baseLayer": {
		"ids": [
			"GROUND_2_0"
		],
		"grid": [
			"0000000000",
			"1111111111",
			"1111111111",
			"1111111111",
			"1111111111",
			"1111111111",
			"1111111111",
			"1111111111",
			"1111111111",
			"1111111111",
			"1111111111"
		]
	},
	"overLayer": {
		"ids": [
			"2_0_3_3",
			"2_0_1_5",
			"2_0_4_3"
		],
		"grid": [
			"0001223000",
			"0000000000",
			"0000000000",
			"0000000000",
			"0000000000",
			"0000000000",
			"0000000000",
			"0000000000",
			"0000000000",
			"0000000000",
			"0000000000"
		]
	},
	"wallLayer": {
		"ids": [
			"1_0"
		],
		"grid": [
			"0000000000",
			"1111001111",
			"1000000001",
			"1000000001",
			"1000000001",
			"1000000001",
			"1000000001",
			"1000000001",
			"1000000001",
			"1000000001",
			"1111111111"
		]
	},
	"attribLayer": {
		"ids": [
			"BLOCK",
			"WARP: main 33 28"
		],
		"grid": [
			"0001221000",
			"1111001111",
			"1000000001",
			"1000000001",
			"1000000001",
			"1000000001",
			"1000000001",
			"1000000001",
			"1000000001",
			"1000000001",
			"1111111111"
		]
	},
	"decoLayer": {
		"ids": [],
		"grid": [
			"0000000000",
			"0000000000",
			"0000000000",
			"0000000000",
			"0000000000",
			"0000000000",
			"0000000000",
			"0000000000",
			"0000000000",
			"0000000000",
			"0000000000"
		]
	}
}