{
	"width": 50,
	"height": 50,
	"baseLayer": {
		"ids": [
			"GROUND_0_0",
			"WATER",
			"GROUND_1_0",
			"GROUND_3_0"
		],
		"grid": [
			"11111111111111111111111111111111111111222222222222",
			"11111111111111111111111111111111111111222222222222",
			"11111111111111111111111111111111111111222222222222",
			"11111111111111111111111111111111111111222222222222",
			"11111111111111111111111111111111111111222222222222",
			"11111111111111111111111111111111111111222222222222",
			"11111111111111111111111111111111111111222222222222",
			"11111111111111111111111111111111111111222222222222",
			"12222222111111111111111111111111111111222222222222",
			"12222222111111111111111111111111111111222222222222",
			"12222222111111111111111111111111111111222222222222",
			"12222222111111111111111111111111111111222222222222",
			"12222222111111111111113331111111111111222222222222",
			"12222222111111111111113331111111111111222222222222",
			"12222222111111111111113331111111111111222222222222",
			"12222222111111111111113331111111111111222222222222",
			"12222222111111111111113331111111111111222222222222",
			"12222222111111111111113331111111111111222222222222",
			"12222222111111111111113331111111111111222222222222",
			"11111111111111444444413331444444441111222222222222",
			"11111111111111444444413331444444441111222222222222",
			"11111111111111444444413331144444441111222222222222",
			"11111111111111444444413331444444441111222222222222",
			"11111111111111444444413331444444441111222222222222",
			"11111111111111111411113331111114111111222222222222",
			"11111111111111113331113331111133311111222222222222",
			"11111111111111113331113331111133311111222222222222",
			"13333333333333333333333333333333311111222222222222",
			"13333333333333333333333333333333311111222222222222",
			"13333333333333333333333333333333311111222222222222",
			"11111111111111111111111111111111111111222222222222",
			"11111111111111111111111111111111111111222222222222",
			"11111111111111111111111111111111111111222222222222",
			"11111111111111111111111111111111111111222222222222",
			"11111111111111111111111111111111111111222222222222",
			"11111111111111111111111111111111111111222222222222",
			"11111111111111111111111111111111111111222222222222",
			"11111111111111111111111111111111111111222222222222",
			"11111111111111111111111111111111111111222222222222",
			"11111111111111111111111111111111111111222222222222",
			"11111111111111111111111111111111111111222222222222",
			"11111111111111111111111111111111111111222222222222",
			"11111111111111111111111111111111111111222222222222",
			"11111111111111111111111111111111111111222222222222",
			"11111111111111111111111111111111111111222222222222",
			"11111111111111111111111111111111111111222222222222",
			"11111111111111111111111111111111111111222222222222",
			"11111111111111111111111111111111111111222222222222",
			"11111111111111111111111111111111111111222222222222",
			"11111111111111111111111111111111111111222222222222"
		]
	},
	"overLayer": {
		"ids": [
			"0_0_0_1",
			"0_0_0_0",
			"0_0_1_0",
			"0_0_2_0",
			"0_0_2_1",
			"0_0_0_2",
			"0_0_1_2",
			"0_0_2_2",
			"0_0_4_1",
			"0_0_3_1"
		],
		"grid": [
			"0000000000000000000000000000000000000000000000000000000000000000000000000000010000000000000000000000",
			"0000000000000000000000000000000000000000000000000000000000000000000000000000010000000000000000000000",
			"0000000000000000000000000000000000000000000000000000000000000000000000000000010000000000000000000000",
			"0000000000000000000000000000000000000000000000000000000000000000000000000000010000000000000000000000",
			"0000000000000000000000000000000000000000000000000000000000000000000000000000010000000000000000000000",
			"0000000000000000000000000000000000000000000000000000000000000000000000000000010000000000000000000000",
			"0000000000000000000000000000000000000000000000000000000000000000000000000000010000000000000000000000",
			"0000000000000000000000000000000000000000000000000000000000000000000000000000010000000000000000000000",
			"0002030303030304000000000000000000000000000000000000000000000000000000000000010000000000000000000000",
			"0001000000000005000000000000000000000000000000000000000000000000000000000000010000000000000000000000",
			"0001000000000005000000000000000000000000000000000000000000000000000000000000010000000000000000000000",
			"0001000000000005000000000000000000000000000000000000000000000000000000000000010000000000000000000000",
			"0001000000000005000000000000000000000000000002030400000000000000000000000000010000000000000000000000",
			"0001000000000005000000000000000000000000000001000500000000000000000000000000010000000000000000000000",
			"0001000000000005000000000000000000000000000001000500000000000000000000000000010000000000000000000000",
			"0001000000000005000000000000000000000000000001000500000000000000000000000000010000000000000000000000",
			"0001000000000005000000000000000000000000000001000500000000000000000000000000010000000000000000000000",
			"0001000000000005000000000000000000000000000001000500000000000000000000000000010000000000000000000000",
			"0006070707070708000000000000000000000000000001000500000000000000000000000000010000000000000000000000",
			"0000000000000000000000000000000000000000000001000500000000000000000000000000010000000000000000000000",
			"0000000000000000000000000000000000000000000001000500000000000000000000000000010000000000000000000000",
			"0000000000000000000000000000000000000000000001000500000000000000000000000000010000000000000000000000",
			"0000000000000000000000000000000000000000000001000500000000000000000000000000010000000000000000000000",
			"0000000000000000000000000000000000000000000001000500000000000000000000000000010000000000000000000000",
			"0000000000000000000000000000000000000000000001000500000000000000000000000000010000000000000000000000",
			"0000000000000000000000000000000001000500000001000500000000000100050000000000010000000000000000000000",
			"0000000000000000000000000000000001000500000001000500000000000100050000000000010000000000000000000000",
			"0003030303030303030303030303030309001003030309001003030303030900050000000000010000000000000000000000",
			"0000000000000000000000000000000000000000000000000000000000000000050000000000010000000000000000000000",
			"0007070707070707070707070707070707070707070707070707070707070707080000000000010000000000000000000000",
			"0000000000000000000000000000000000000000000000000000000000000000000000000000010000000000000000000000",
			"0000000000000000000000000000000000000000000000000000000000000000000000000000010000000000000000000000",
			"0000000000000000000000000000000000000000000000000000000000000000000000000000010000000000000000000000",
			"0000000000000000000000000000000000000000000000000000000000000000000000000000010000000000000000000000",
			"0000000000000000000000000000000000000000000000000000000000000000000000000000010000000000000000000000",
			"0000000000000000000000000000000000000000000000000000000000000000000000000000010000000000000000000000",
			"0000000000000000000000000000000000000000000000000000000000000000000000000000010000000000000000000000",
			"0000000000000000000000000000000000000000000000000000000000000000000000000000010000000000000000000000",
			"0000000000000000000000000000000000000000000000000000000000000000000000000000010000000000000000000000",
			"0000000000000000000000000000000000000000000000000000000000000000000000000000010000000000000000000000",
			"0000000000000000000000000000000000000000000000000000000000000000000000000000010000000000000000000000",
			"0000000000000000000000000000000000000000000000000000000000000000000000000000010000000000000000000000",
			"0000000000000000000000000000000000000000000000000000000000000000000000000000010000000000000000000000",
			"0000000000000000000000000000000000000000000000000000000000000000000000000000010000000000000000000000",
			"0000000000000000000000000000000000000000000000000000000000000000000000000000010000000000000000000000",
			"0000000000000000000000000000000000000000000000000000000000000000000000000000010000000000000000000000",
			"0000000000000000000000000000000000000000000000000000000000000000000000000000010000000000000000000000",
			"0000000000000000000000000000000000000000000000000000000000000000000000000000010000000000000000000000",
			"0000000000000000000000000000000000000000000000000000000000000000000000000000010000000000000000000000",
			"0000000000000000000000000000000000000000000000000000000000000000000000000000010000000000000000000000"
		]
	},
	"wallLayer": {
		"ids": [
			"0_0"
		],
		"grid": [
			"00000000000000000000000000000000000000000000000000",
			"00000000000000000000000000000000000000000000000000",
			"00000000000000000000000000000000000000000000000000",
			"00000000000000000000000000000000000000000000000000",
			"00000000000000000000000000000000000000000000000000",
			"00000000000000000000000000000000000000000000000000",
			"00000000000000000000000000000000000000000000000000",
			"00000000000000000000000000000000000000000000000000",
			"00000000000000000000000000000000000000000000000000",
			"00000000000000000000000000000000000000000000000000",
			"00000000000000000000000000000000000000000000000000",
			"00000000000000000000000000000000000000000000000000",
			"00000000000000000000000000000000000000000000000000",
			"00000000000000000000000000000000000000000000000000",
			"00000000000000000000000000000000000000000000000000",
			"00000000000000000000000000000000000000000000000000",
			"00000000000000000000000000000000000000000000000000",
			"00000000000000000000000000000000000000000000000000",
			"00000000000001111111110001111111111000000000000000",
			"00000000000001000000010001000000001000000000000000",
			"00000000000001000000010001001000001000000000000000",
			"00000000000001000000010001111000001000000000000000",
			"00000000000001000000010001000000001000000000000000",
			"00000000000001000000010001000000001000000000000000",
			"00000000000001111011110001111110111000000000000000",
			"00000000000000000000000000000000000000000000000000",
			"00000000000000000000000000000000000000000000000000",
			"00000000000000000000000000000000000000000000000000",
			"00000000000000000000000000000000000000000000000000",
			"00000000000000000000000000000000000000000000000000",
			"00000000000000000000000000000000000000000000000000",
			"00000000000000000000000000000000000000000000000000",
			"00000000000000000000000000000000000000000000000000",
			"00000000000000000000000000000000000000000000000000",
			"00000000000000000000000000000000000000000000000000",
			"00000000000000000000000000000000000000000000000000",
			"00000000000000000000000000000000000000000000000000",
			"00000000000000000000000000000000000000000000000000",
			"00000000000000000000000000000000000000000000000000",
			"00000000000000000000000000000000000000000000000000",
			"00000000000000000000000000000000000000000000000000",
			"00000000000000000000000000000000000000000000000000",
			"00000000000000000000000000000000000000000000000000",
			"00000000000000000000000000000000000000000000000000",
			"00000000000000000000000000000000000000000000000000",
			"00000000000000000000000000000000000000000000000000",
			"00000000000000000000000000000000000000000000000000",
			"00000000000000000000000000000000000000000000000000",
			"00000000000000000000000000000000000000000000000000",
			"00000000000000000000000000000000000000000000000000"
		]
	},
	"attribLayer": {
		"ids": [
			"BLOCK",
			"OBJECT: tree_common",
			"NPC: slime_weak",
			"WARP: main 15 37",
			"NPC: cat_white",
			"NPC: wizard",
			"OBJECT: crate_small",
			"NPC: t_t_c",
			"OBJECT: torch_common"
		],
		"grid": [
			"00000000000000000000000000000000000000000000000000",
			"00000000000000000000000000000000000000000000000000",
			"00000000000000000000000000000000000000000000000000",
			"00000000000000000000000000000000000000000000000000",
			"00000000000000000000000000000000000000000000000000",
			"00000000000000000000000000000000000000000000000000",
			"00000000000000000000000000000000000000000000000000",
			"00000000000000000000000000000000000000000000000000",
			"01111111000000000000000000000000000000000000000000",
			"01000001000000000000000000000000000000000000000000",
			"01000001000000000000000000000000000000000000000000",
			"01000001000000000000000000000000000000000000000000",
			"01000001000000000000000000000000000000000000000000",
			"01000001000000000000000000000000000000000000000000",
			"01000001000000000000000000000000000000000000000000",
			"01000001000000000000020000000000000000000000000000",
			"01000001020000000000000000000002000002000000000000",
			"01000001000000000000000000000000000000000000000000",
			"01111111003001111111110001111111111000000000000000",
			"00003000000001000400010001500000001000000000000000",
			"00000000000001060007010001001000001000000000000000",
			"00000000000201000007010001111000801020000000000000",
			"00002003000001000007010001000000001000000000000000",
			"00000000003001000000010001000000001000000000000000",
			"00030000000001111011110001111110111000000000000000",
			"00000000000000000000000000000000000000000000000000",
			"00000000020000090009000000200900090000000000000000",
			"00000000000000000000000000000000000000000000000000",
			"00000000000000000000000000000000000002000000000000",
			"00000000000000000000000000000000000000000000000000",
			"00002000000000000000000000000000020000000000000000",
			"00000000000000000000000000000000000000000000000000",
			"00000000000020000000000000020000000000000000000000",
			"00000000000000000000000000000000000000000000000000",
			"00000000000000000000000000000000000000000000000000",
			"00000000000000000000000000000000000000000000000000",
			"00000000000000000000000000000000000000000000000000",
			"00000000000000000000000000000000000000000000000000",
			"00000000000000000000000000000000000000000000000000",
			"00000000000000000000000000000000000000000000000000",
			"00000000000000000000000000000000000000000000000000",
			"00000000000000000000000000000000000000000000000000",
			"00000000000000000000000000000000000000000000000000",
			"00000000000000000000000000000000000000000000000000",
			"00000000000000000000000000000000000000000000000000",
			"00000000000000000000000000000000000000000000000000",
			"00000000000000000000000000000000000000000000000000",
			"00000000000000000000000000000000000000000000000000",
			"00000000000000000000000000000000000000000000000000",
			"00000000000000000000000000000000000000000000000000"
		]
	},
	"decoLayer": {
		"ids": [
			"0_0",
			"3_0",
			"1_0",
			"4_0",
			"2_0"
		],
		"grid": [
			"00000000000000000000000000000000000000000000000000",
			"00000000000000000000000000000000000000000000000000",
			"00000000000000000000000000000000000000000000000000",
			"00000000000000000000000000000000000000000000000000",
			"00000000000000000000000000000000000000000000000000",
			"00000000000000000000000000000000000000000000000000",
			"00000000000000000000000000000000000000000000000000",
			"00000000000000000000000000000000000000000000000000",
			"00000000000000000000000000000000000000000000000000",
			"00000000000000000000000000000000000000000000000000",
			"00000000000000000000000000000000000000000000000000",
			"00000000000000000000000000000000000000000000000000",
			"00000000000000000000000000000000000000000000000000",
			"00000001000000000000000000000000000000000000000000",
			"00000000000001000000000000000000000000000000000000",
			"00000000000000000002000000100000000000000000000000",
			"00000000000000000000000000000000000000000000000000",
			"00000000000000000010000000000000003000000000000000",
			"00000000000000000000000000000000000000000000000000",
			"00000000000000000400000000000000000000000000000000",
			"00000003000000000000000000000000000000000000000000",
			"00000000000000000000000000000000000000000000000000",
			"00000000000000000000000000000000000000000000000000",
			"00000000000000000000000000000000000000000000000000",
			"00000002000000000000000000000000000000000000000000",
			"00000000000000000000000000000000000000000000000000",
			"00000500000000000000000000000000000000000000000000",
			"00000000000000000000000000000000001000000000000000",
			"00000000000000000000000000000000000000000000000000",
			"00000000000000000000000000000000000000000000000000",
			"00000000000000000500000000000000000000000000000000",
			"00000003000000000000000000000000000000000000000000",
			"00000000000000000000000010000000000000000000000000",
			"00000000000000000000000000000000000000000000000000",
			"00000000000000000000000000000000000000000000000000",
			"00000000000000000000000000000000000000000000000000",
			"00000000000000000000000000000000000000000000000000",
			"00000000000000000000000000000000000000000000000000",
			"00000000000000000000000000000000000000000000000000",
			"00000000000000000000000000000000000000000000000000",
			"00000000000000000000000000000000000000000000000000",
			"00000000000000000000000000000000000000000000000000",
			"00000000000000000000000000000000000000000000000000",
			"00000000000000000000000000000000000000000000000000",
			"00000000000000000000000000000000000000000000000000",
			"00000000000000000000000000000000000000000000000000",
			"00000000000000000000000000000000000000000000000000",
			"00000000000000000000000000000000000000000000000000",
			"00000000000000000000000000000000000000000000000000",
			"00000000000000000000000000000000000000000000000000"
		]
	}
}