{
	"width": 50,
	"height": 50,
	"baseLayer": {
		"ids": [
			"GROUND_0_0",
			"WATER",
			"GROUND_1_0",
			"GROUND_3_0"
		],
		"grid": [
			"11111111111111111111111111111111111111222222222222",
			"11111111111111111111111111111111111111222222222222",
			"11111111111111111111111111111111111111222222222222",
			"11111111111111111111111111111111111111222222222222",
			"11111111111111111111111111111111111111222222222222",
			"11111111111111111111111111111111111111222222222222",
			"11111111111111111111111111111111111111222222222222",
			"11111111111111111111111111111111111111222222222222",
			"11111111111111111111111111111111111111222222222222",
			"11111111111111111111111111111111111111222222222222",
			"11111111111111111111111111111111111111222222222222",
			"11111111111111111111111111111111111111222222222222",
			"11111111111111111111113331111111111111222222222222",
			"11111111111111111111113331111111111111222222222222",
			"11111111111111111111113331111111111111222222222222",
			"11111111111111111111113331111111111111222222222222",
			"11111111111111111111113331111111111111222222222222",
			"11111111111111111111113331111111111111222222222222",
			"11111111111111111111113331111111111111222222222222",
			"11111111111111444444413331444444441111222222222222",
			"11111111111111444444413331444444441111222222222222",
			"11111111111111444444413331144444441111222222222222",
			"11111111111111444444413331444444441111222222222222",
			"11111111111111444444413331444444441111222222222222",
			"11111111111111111411113331111114111111222222222222",
			"11111111111111113331113331111133311111222222222222",
			"11111111111111113331113331111133311111222222222222",
			"33333333333333333333333333333333311111222222222222",
			"33333333333333333333333333333333311111222222222222",
			"33333333333333333333333333333333311111222222222222",
			"11111111111111111111111111111111111111222222222222",
			"11111111111111111111111111111111111111222222222222",
			"11111111111111111111111111111111111111222222222222",
			"11111111111111111111111111111111111111222222222222",
			"11111111111111111111111111111111111111222222222222",
			"11111111111111111111111111111111111111222222222222",
			"11111111111111111111111111111111111111222222222222",
			"11111111111111111111111111111111111111222222222222",
			"11111111111111111111111111111111111111222222222222",
			"11111111111111111111111111111111111111222222222222",
			"11111111111111111111111111111111111111222222222222",
			"11111111111111111111111111111111111111222222222222",
			"11111111111111111111111111111111111111222222222222",
			"11111111111111111111111111111111111111222222222222",
			"11111111111111111111111111111111111111222222222222",
			"11111111111111111111111111111111111111222222222222",
			"11111111111111111111111111111111111111222222222222",
			"11111111111111111111111111111111111111222222222222",
			"11111111111111111111111111111111111111222222222222",
			"11111111111111111111111111111111111111222222222222"
		]
	},
	"overLayer": {
		"ids": [
			"0_0_0_1",
			"0_0_0_0",
			"0_0_1_0",
			"0_0_2_0",
			"0_0_2_1",
			"0_0_4_1",
			"0_0_3_1",
			"0_0_1_2",
			"0_0_2_2"
		],
		"grid": [
			"00000000000000000000000000000000000000100000000000",
			"00000000000000000000000000000000000000100000000000",
			"00000000000000000000000000000000000000100000000000",
			"00000000000000000000000000000000000000100000000000",
			"00000000000000000000000000000000000000100000000000",
			"00000000000000000000000000000000000000100000000000",
			"00000000000000000000000000000000000000100000000000",
			"00000000000000000000000000000000000000100000000000",
			"00000000000000000000000000000000000000100000000000",
			"00000000000000000000000000000000000000100000000000",
			"00000000000000000000000000000000000000100000000000",
			"00000000000000000000000000000000000000100000000000",
			"00000000000000000000002340000000000000100000000000",
			"00000000000000000000001050000000000000100000000000",
			"00000000000000000000001050000000000000100000000000",
			"00000000000000000000001050000000000000100000000000",
			"00000000000000000000001050000000000000100000000000",
			"00000000000000000000001050000000000000100000000000",
			"00000000000000000000001050000000000000100000000000",
			"00000000000000000000001050000000000000100000000000",
			"00000000000000000000001050000000000000100000000000",
			"00000000000000000000001050000000000000100000000000",
			"00000000000000000000001050000000000000100000000000",
			"00000000000000000000001050000000000000100000000000",
			"00000000000000000000001050000000000000100000000000",
			"00000000000000001050001050000010500000100000000000",
			"00000000000000001050001050000010500000100000000000",
			"33333333333333336073336073333360500000100000000000",
			"00000000000000000000000000000000500000100000000000",
			"88888888888888888888888888888888900000100000000000",
			"00000000000000000000000000000000000000100000000000",
			"00000000000000000000000000000000000000100000000000",
			"00000000000000000000000000000000000000100000000000",
			"00000000000000000000000000000000000000100000000000",
			"00000000000000000000000000000000000000100000000000",
			"00000000000000000000000000000000000000100000000000",
			"00000000000000000000000000000000000000100000000000",
			"00000000000000000000000000000000000000100000000000",
			"00000000000000000000000000000000000000100000000000",
			"00000000000000000000000000000000000000100000000000",
			"00000000000000000000000000000000000000100000000000",
			"00000000000000000000000000000000000000100000000000",
			"00000000000000000000000000000000000000100000000000",
			"00000000000000000000000000000000000000100000000000",
			"00000000000000000000000000000000000000100000000000",
			"00000000000000000000000000000000000000100000000000",
			"00000000000000000000000000000000000000100000000000",
			"00000000000000000000000000000000000000100000000000",
			"00000000000000000000000000000000000000100000000000",
			"00000000000000000000000000000000000000100000000000"
		]
	},
	"wallLayer": {
		"ids": [
			"0_0"
		],
		"grid": [
			"00000000000000000000000000000000000000000000000000",
			"00000000000000000000000000000000000000000000000000",
			"00000000000000000000000000000000000000000000000000",
			"00000000000000000000000000000000000000000000000000",
			"00000000000000000000000000000000000000000000000000",
			"00000000000000000000000000000000000000000000000000",
			"00000000000000000000000000000000000000000000000000",
			"00000000000000000000000000000000000000000000000000",
			"00000000000000000000000000000000000000000000000000",
			"00000000000000000000000000000000000000000000000000",
			"00000000000000000000000000000000000000000000000000",
			"00000000000000000000000000000000000000000000000000",
			"00000000000000000000000000000000000000000000000000",
			"00000000000000000000000000000000000000000000000000",
			"00000000000000000000000000000000000000000000000000",
			"00000000000000000000000000000000000000000000000000",
			"00000000000000000000000000000000000000000000000000",
			"00000000000000000000000000000000000000000000000000",
			"00000000000001111111110001111111111000000000000000",
			"00000000000001000000010001000000001000000000000000",
			"00000000000001000000010001001000001000000000000000",
			"00000000000001000000010001111000001000000000000000",
			"00000000000001000000010001000000001000000000000000",
			"00000000000001000000010001000000001000000000000000",
			"00000000000001111011110001111110111000000000000000",
			"00000000000000000000000000000000000000000000000000",
			"00000000000000000000000000000000000000000000000000",
			"00000000000000000000000000000000000000000000000000",
			"00000000000000000000000000000000000000000000000000",
			"00000000000000000000000000000000000000000000000000",
			"00000000000000000000000000000000000000000000000000",
			"00000000000000000000000000000000000000000000000000",
			"00000000000000000000000000000000000000000000000000",
			"00000000000000000000000000000000000000000000000000",
			"00000000000000000000000000000000000000000000000000",
			"00000000000000000000000000000000000000000000000000",
			"00000000000000000000000000000000000000000000000000",
			"00000000000000000000000000000000000000000000000000",
			"00000000000000000000000000000000000000000000000000",
			"00000000000000000000000000000000000000000000000000",
			"00000000000000000000000000000000000000000000000000",
			"00000000000000000000000000000000000000000000000000",
			"00000000000000000000000000000000000000000000000000",
			"00000000000000000000000000000000000000000000000000",
			"00000000000000000000000000000000000000000000000000",
			"00000000000000000000000000000000000000000000000000",
			"00000000000000000000000000000000000000000000000000",
			"00000000000000000000000000000000000000000000000000",
			"00000000000000000000000000000000000000000000000000",
			"00000000000000000000000000000000000000000000000000"
		]
	},
	"attribLayer": {
		"ids": [
			"OBJECT: tree_apple",
			"OBJECT: tree_birch",
			"OBJECT: bush",
			"OBJECT: tree_common",
			"OBJECT: stump_common",
			"NPC: ent",
			"NPC: slime_weak",
			"BLOCK",
			"WARP: main 15 37",
			"NPC: cat_white",
			"NPC: wizard",
			"OBJECT: crate_small",
			"NPC: t_t_c",
			"OBJECT: torch_common"
		],
		"grid": [
			"0000000000000000000000000000000000000000000000000000000000000000000000000000000000000000000000000000",
			"0000000000000000000000000000000000000100000000020003000000000000000000000000000000000000000000000000",
			"0004000000020000000000000200000000000000000000000000000000000004000000000000000000000000000000000000",
			"0000000000000000000000000000000000000000000000000000000000000000000000000000000000000000000000000000",
			"0000000000000000000000000000000000000000000000000000000400000000000000000000000000000000000000000000",
			"0000000000000000000500000000000002000000000400000000000000000000000000020000000000000000000000000000",
			"0000000000000000000000000000000000000000000000000000000000000000000000000000000000000000000000000000",
			"0000030000050000000000020000040000000000000000000000000000000000000000000000000000000000000000000000",
			"0000000000000000000000000000000000000300000000000000000000000600000000000000000000000000000000000000",
			"0000000000000000000000000000000000000000000002000000000000000000000000000000000000000000000000000000",
			"0000000000000000000004000000000000000000000000000000000000000000000000040000000000000000000000000000",
			"0000000000020000000000000005000000000000000000000000000400000000000000000000000000000000000000000000",
			"0001000000000000000000000000000001000000000000000000000000000000000000000000000000000000000000000000",
			"0000000000000000000000000000000000000000000000000000000000000000020000000000000000000000000000000000",
			"0000000000000000000000000000000000000000000000000000000003000000000000000000000000000000000000000000",
			"0000000000000000000000000000000000000000000400000000000000000000000000000000000000000000000000000000",
			"0000000500000000000400000000000000000000000000000000000000000004000000000004000000000000000000000000",
			"0000000000000000000000000000000000000000000000000000000000000000000000000000000000000000000000000000",
			"0000000000000000000007000008080808080808080800000008080808080808080808000000000000000000000000000000",
			"0000000007000000000000000008000000090000000800000008100000000000000008000000000000000000000000000000",
			"0000000000000000000000000008001100000012000800000008000008000000000008000000000000000000000000000000",
			"0000000000000000000000040008000000000012000800000008080808000000130008000400000000000000000000000000",
			"0000000004000007000000000008000000000012000800000008000000000000000008000000000000000000000000000000",
			"0000000000000000000007000008000000000000000800000008000000000000000008000000000000000000000000000000",
			"0000000700000000000000000008080808000808080800000008080808080800080808000000000000000000000000000000",
			"0000000000000000000000000000000000000000000000000000000000000000000000000000000000000000000000000000",
			"0300000000000000000400000000001400000014000000000000040000140000001400000000000000000000000000000000",
			"0000000000000000000000000000000000000000000000000000000000000000000000000000000000000000000000000000",
			"0000000000000000000000000000000000000000000000000000000000000000000000000004000000000000000000000000",
			"0000000000000000000000000000000000000000000000000000000000000000000000000000000000000000000000000000",
			"0300000001000000000000000000000000000000000000000000000000000000000100000000000000000000000000000000",
			"0000000000000000000000000000000000000000000000000000000000000000000000000000000000000000000000000000",
			"0000000000000000000000000400000000000004000000000000000400000000000000000000000000000000000000000000",
			"0000000000000000000000000000000000000000000500000000000000000000000000000000000000000000000000000000",
			"0000050000000000000000000000000000000000000000000000000000000000000000000000000000000000000000000000",
			"0000000000000000000000030000000000000000000000000000000005000000000000000000000000000000000000000000",
			"0000000000000000000000000005000000000000000000000400000000000000000000040000000000000000000000000000",
			"0000000000000000040000000000000000010000000000000000000000000000000000000000000000000000000000000000",
			"0000000000000000000000000000000000000000000000000000000000000100000000000000000000000000000000000000",
			"0000010000000000000500000000000000000000000000000000000000000000000000000000000000000000000000000000",
			"0000000000000000000000000000000000000000030000000000000000000000000000000000000000000000000000000000",
			"0000000000000300000000000000000000040000000000000004000000000500000000000000000000000000000000000000",
			"0000000000000000000000000000050000000000000000000000000000000000000004000000000000000000000000000000",
			"0000000000000000000001000000000000000000000000000000000000000000000000000000000000000000000000000000",
			"0000000000050000000000000000000000000000000000000000000000000000000000000000000000000000000000000000",
			"0000000000000000000000000000000000000000000001000000000000000400000000000000000000000000000000000000",
			"0000000000000000000000000000000000000000000000000000000000000000000000030000000000000000000000000000",
			"0000040000000000000000000000040000000000000000000000000000000000000000000000000000000000000000000000",
			"0000000000000000000000000000000000000000000000000000050000000000000000000000000000000000000000000000",
			"0000000000000000000000000000000000000000000000000000000000000000000000000000000000000000000000000000"
		]
	},
	"decoLayer": {
		"ids": [
			"0_0",
			"3_0",
			"2_0",
			"1_0",
			"4_0"
		],
		"grid": [
			"00000000000000000000000000000000000000000000000000",
			"01000000002000000000000000000000002000000000000000",
			"00000000000000000000020000000000000000000000000000",
			"00000000000000300000000000000000000000000000000000",
			"00000300000000000000000000000000000000000000000000",
			"00200000001000000000000000000000000000000000000000",
			"00000000000000000000000000200000000000000000000000",
			"00000000000000000000000000000000000200000000000000",
			"00000040000000000000000000000000000000000000000000",
			"00000000000002000400000020000000000000000000000000",
			"03000000000000000000000000000020000000000000000000",
			"00000000000000000000000000000000000000000000000000",
			"00000000000000000000000000000000000000000000000000",
			"00000001000000000000000000000200000000000000000000",
			"00000000000001000000000000000000000000000000000000",
			"00100000000000000002000000100000000000000000000000",
			"00000000000000000000000000000000000000000000000000",
			"00000000000000000010000000000000004000000000000000",
			"00000000000000000000000000000000000000000000000000",
			"00000000000000000500000000000000000000000000000000",
			"00000004000000000000000000000000000000000000000000",
			"00000000000000000000000000000000000000000000000000",
			"00000000000000000000000000000000000000000000000000",
			"00000000000000000000000000000000000000000000000000",
			"00000002000000000000000000000000000000000000000000",
			"00000000000000000000000000000000000000000000000000",
			"00000300000000000000000000000000000000000000000000",
			"00000000000000000000000000000000001000000000000000",
			"00000000000000000000000000000000000000000000000000",
			"00000000000000000000000000000000000000000000000000",
			"00000000000000000300000000000000000000000000000000",
			"00000004000000000000000000000000000040000000000000",
			"00020000000000000000000010000000000000000000000000",
			"00000000000000004000000000000020010000000000000000",
			"00000000003000000000000000000030000000000000000000",
			"00000100000000000000300000000000000000000000000000",
			"00000000000000000000000000000000000000000000000000",
			"00000000000000000000000000000000040000000000000000",
			"00000000000000000000020030400000000000000000000000",
			"00003000000002000000000000000000001000000000000000",
			"00000000000000000000000000000000000000000000000000",
			"00000000000000000000000000010000000000000000000000",
			"00100200000000000004000000000000000000000000000000",
			"00000000000000000000000030000000000000000000000000",
			"00000000000000000200000000000000000000000000000000",
			"00000000000001000000000000200000000000000000000000",
			"00000000020000000003000000000000000000000000000000",
			"00000000000000000000040000001000040000000000000000",
			"00004000000010000000000000000000000000000000000000",
			"00000003000000000000000000000000000000000000000000"
		]
	}
}